Member names with brief description
-----------------------------------
$README  THIS DOCUMENTATION MEMBER
ALIASBLD BUILDS THE ALIAS MEMBERS FOR POINT AND SHOOT COMMANDS
BLK      CALCULATES A LIST OF OPTIMAL DATASET BLKSIZES
BLKSIZE  CALCULATES OPTIMAL DATASET BLOCK SIZE FOR SUPPLIED LRECL
BLK90    CALCULATES OPTIMAL DATASET BLOCK SIZE - RUNS AS AN EDIT MACRO
BR       BROWSE A DATASET AT CURSOR POSITION - ALIAS OF ED
CBLCOMP  COBOL COMPILE USING IGYWCL PROC
CBLCOMP1 COBOL COMPILE USING IGYWCL PROC W/ALT SYSIN AND SYSLIB
DATE     DISPLAYS CURR OR FUT DATE - DATE J20123 / DATE 05022020
ED       EDIT A DATASET AT CURSOR POSITION - POINT AND SHOOT
EXPDIR   EXPANDS A PDS BY 1 DIRECTORY BLOCK  - ALIAS OF XCPY
GETCOPY  EDIT MACRO THAT EXPANDS ALL COBOL COPYBOOKS USED IN A PROGRAM
MORE     OPEN A NEW ISPF SESSION (SPLIT NEW, SWAP LIST IS BETTER)
MYCLIST  POINT AND SHOOT - userid().CLIST    - ALIAS OF TJCL
MYJCL    POINT AND SHOOT - userid().TEST.JCL      - ALIAS OF TJCL
PCBL     POINT AND SHOOT - ZOS.PUBLIC.CBL         - ALIAS OF TCLIST
PCBLA    POINT AND SHOOT - ZOS.PUBLIC.ADHOC.CBL   - ALIAS OF TCLIST
PCLIST   POINT AND SHOOT - ZOS.PUBLIC.ADHOC.CLIST - ALIAS OF TCLIST
PCLISTA  POINT AND SHOOT - ZOS.PUBLIC.ADHOC.CLIST - ALIAS OF TCLIST
PCLISTV  POINT AND SHOOT - VENDOR.CLIST           - ALIAS OF TCLIST
PCOBOL   POINT AND SHOOT - userid().TEST.COBOL    - ALIAS OF TCLIST
PCOPY    POINT AND SHOOT - userid().COPYLIB       - ALIAS OF PJCL
PDATA    POINT AND SHOOT - ZOS.PUBLIC.DATA        - ALIAS OF TCLIST
PDEMO    POINT AND SHOOT - userid().JCL - default - ALIAS OF TCLIST
PDFIBM   LAUNCH ISPF/PDF FROM THE READY PROMPT WITH LOGON CONFIGURATION
PJCL     POINT AND SHOOT - ZOS.PUBLIC.JCL         - MASTER MEMBER
PJCLA    POINT AND SHOOT - ZOS.PUBLIC.ADHOC.JCL   - ALIAS OF PJCL
PJCLT    POINT AND SHOOT - userid().TEST.JCL      - ALIAS OF PJCL
PLOAD    POINT AND SHOOT - ZOS.PUBLIC.LOAD        - ALIAS OF TCLIST
PPARM    POINT AND SHOOT - VENDOR.PARMLIB         - ALIAS OF TCLIST
PPROC    POINT AND SHOOT - VENDOR.PROCLIB         - ALIAS OF PJCL
PSDATA   POINT AND SHOOT - ZOS.PUBLIC.SEQ.DATA    - ALIAS OF TJCL
RXTRY    REXX EXEC FOR TESTING COMMANDS ENTERED FROM THE KEYBOARD
SCOTTJCL POINT AND SHOOT - Z80027.TEST.JCL        - ALIAS OF TJCL
TCBL     POINT AND SHOOT - userid().CBL           - ALIAS OF TCLIST
TCLIST   POINT AND SHOOT - userid().CLIST
TCLISTV  POINT AND SHOOT - VENDOR.CLIST           - ALIAS OF TCLIST
TCOBOL   POINT AND SHOOT - userid().TEST.COBOL    - ALIAS OF TCLIST
TCOPY    POINT AND SHOOT - userid().COPYLIB       - ALIAS OF PJCL
TDATA    POINT AND SHOOT - userid().DATA          - ALIAS OF TCLIST
TDEMO    POINT AND SHOOT - userid().JCL - default - ALIAS OF TJCL
TJCL     POINT AND SHOOT - userid().JCL
TJCLA    POINT AND SHOOT - userid().JCL - default - ALIAS OF PJCL
TJCLT    POINT AND SHOOT - userid().TEST.JCL      - ALIAS OF PJCL
TLOAD    POINT AND SHOOT - userid().LOAD          - ALIAS OF TCLIST
TPARM    POINT AND SHOOT - VENDOR.PARMLIB         - ALIAS OF TCLIST
TPROC    POINT AND SHOOT - VENDOR.PROCLIB         - ALIAS OF PJCL
TSDATA   POINT AND SHOOT - userid().DATA          - ALIAS OF TJCL
WHOAMI   RETURNS SIGNED ON TSO USER ID
XCPY     COPY TO A NEW DSN ON THE 3.4 LIST SCREEN - XCPYT IS AN ALIAS
XCPYT    COPY TO A NEW DSN ON THE 3.4 LIST SCREEN - FORCE UNIT(TEST)
ZOSVER   DISPLAYS ZOS VERSION INFORMATION

